********************************
*         *                    *
*    *    *  ***               *
*    *    *    *        ****   *
*    *    *    *               *
*    *    *    *               *
*    *         *   ****        *
*                             E* 
*         *    *            ****
*    *    *  ***               *
*    *    *    *    ****       *
*    *    *    *               *
*    *    *  ***      ****     *
*S   *                         *
********************************